#############
#     #    E#
##### # ### #
#   # #   # #
# # # ##### #
# # #       #
### ####### #
#   #       #
# ### #######
# #   #     #
# # ####### #
#S          #
#############